border_size=1
usage=map

       Rr,       Rr,       Rr,       Rr,       Rr,       Rr,       Rr,       Rr,       Rr,       Re,       Re,       Re,       Re,       Gg,       Gg,       Gg,       Gg,       Gg,       Gg,       Gg,       Gg,       Gg,       Gg,       Gg,       Hh,       Hh,       Gg,       Gg,       Gg,       Gg,       Gg,       Ss,       Ss,       Ss,       Ss,       Ss,       Ss,       Ss
       Rr,       Rr,       Rr,       Ch,       Rr,       Rr,       Rr,       Re,       Re,       Gg,       Gg,       Gg,       Gg,       Gg,       Gg,       Gg,       Gg,       Gg,       Gg,       Gg,       Gg,       Gg,       Gg,       Gg,       Hh,       Hh,       Hh,       Hh,       Gg,       Gg,       Gg,       Ss,       Ss,       Ss,       Ss,       Ss,       Ss,       Ss
       Rr,       Rr,       Ch,     1 Kh,       Ch,       Re,       Re,       Rr,       Re,       Re,       Gg,       Gg,       Gg,       Gg,       Gg,       Gg,       Gg,       Gg,       Gg,       Gg,       Gg,       Gg,       Gg,       Hh,       Hh,       Hh,       Mm,       Mm,       Hh,       Gg,       Ss,       Ss,       Ss,       Ss,       Ss,       Ss,       Ss,       Gg
       Rr,       Rr,       Ch,       Ch,       Ch,       Re,    Gg^Vh,       Rr,       Rr,       Rr,       Re,       Re,       Gg,       Gg,       Gg,       Gg,       Gg,       Gg,       Gg,       Gg,       Gg,       Gg,       Gg,       Hh,       Hh,       Mm,    Uu^Vu,       Mm,       Mm,       Mm,       Ss,       Gg,    Gg^Ve,       Ss,       Ss,       Ss,       Ss,       Ss
       Rr,       Rr,       Ch,       Ch,       Ch,       Re,    Gg^Vh,       Rr,       Rr,       Rr,       Rr,       Gg,       Re,       Re,       Gg,       Gg,       Gg,       Gg,       Gg,       Gg,       Gg,       Gg,       Hh,       Mm,       Mm,       Mm,       Mm,       Mm,       Mm,       Mm,       Ss,       Ss,       Gg,       Ss,       Ss,       Ss,       Ss,       Ss
       Rr,       Rr,       Rr,       Rr,       Rr,       Re,       Rr,       Gg,       Rr,       Gg,       Gg,       Gg,       Ds,       Re,       Gg,       Gg,       Gg,       Gg,       Gg,       Gg,       Gg,       Gg,       Hh,       Ww,       Ww,       Ww,       Ww,       Mm,       Mm,       Mm,       Mm,       Hh,       Gg,       Ss,       Ss,       Ss,       Ss,       Ss
       Rr,    Gg^Ve,       Rr,       Re,       Re,       Gg,       Gg,       Gg,       Gg,       Gg,       Gg,       Ds,       Ds,       Re,       Gg,       Re,       Gg,       Gg,       Gg,       Gg,       Gg,       Gg,       Ww,       Ww,       Ww,   Ww^Bw/,   Ww^Bw/,       Mm,       Mm,    Uu^Vu,       Mm,       Mm,       Hh,       Gg,       Ss,       Ss,       Ss,       Ss
       Rr,       Re,       Re,       Re,       Re,       Gg,       Ds,       Gg,       Ds,       Gg,       Gg,       Ds,       Gg,       Ds,       Re,       Ds,       Re,       Re,       Re,       Re,       Gg,       Re,       Ww,   Ww^Bw/,   Ww^Bw/,       Ww,       Ww,       Mm,       Mm,       Mm,       Mm,       Hh,       Hh,       Gg,       Ss,       Ss,       Ss,       Ss
       Re,       Re,       Re,       Gg,       Rr,       Gg,       Gg,       Gg,       Gg,       Gg,       Gg,       Gg,       Gg,       Gg,       Gg,       Gg,       Gg,       Gg,       Gg,       Gg,       Re,    Gg^Vh,   Ww^Bw/,       Ww,       Ww,       Hh,       Hh,       Hh,    Gg^Ve,       Gg,       Hh,       Gg,       Gg,       Gg,       Ss,       Ss,       Ss,       Ss
       Re,       Gg,       Rr,       Gg,       Gg,       Gg,       Gg,       Gg,       Gg,       Gg,       Ds,       Gg,       Gg,    Gg^Vh,       Ds,       Gg,       Ds,       Ds,       Ds,       Gg,       Gg,       Gg,       Hh,       Gg,       Ww,       Hh,       Hh,       Gg,       Gg,       Gg,       Gg,       Gg,       Gg,       Gg,       Gg,       Gg,       Ss,       Gg
       Re,       Gg,    Gg^Vh,       Gg,       Gg,       Gg,       Gg,       Gg,       Gg,       Gg,       Ds,       Gg,       Ds,       Gg,       Gg,       Gg,       Ds,       Ds,       Ds,       Ds,       Ds,       Gg,       Gg,       Hh,   Ww^Bw\,       Hh,       Gg,       Gg,       Gg,       Gg,       Gg,       Gg,       Gg,       Gg,       Gg,       Gg,       Gg,       Gg
       Gg,       Gg,       Gg,       Ss,       Gg,       Ss,       Ss,       Gg,       Ss,       Gg,       Gg,       Gg,       Gg,       Gg,       Gg,       Gg,       Ds,       Ds,       Ds,       Ds,       Gg,       Gg,       Gg,       Ww,       Ww,    Gg^Ve,       Gg,       Gg,       Gg,       Gg,       Gg,    Gg^Ve,       Gg,       Gg,       Gg,       Gg,       Gg,       Gg
       Gg,       Ss,       Ss,       Gg,       Gg,       Gg,       Ss,       Gg,       Ss,       Ss,       Gg,       Gg,       Gg,       Gg,       Gg,       Gg,       Ds,       Ds,       Ds,       Ds,       Gg,       Gg,       Gg,       Gg,       Ww,       Ss,       Gg,       Gg,       Gg,       Gg,       Gg,       Gg,       Gg,       Gg,       Gg,       Gg,       Gg,       Gg
       Gg,       Ss,       Ss,       Gg,       Ss,   Ww^Bw|,       Ss,       Gg,       Ss,       Ss,       Gg,       Gg,       Gg,       Ss,       Gg,       Gg,       Gg,       Gg,       Gg,       Gg,       Gg,       Gg,       Gg,       Gg,       Ww,       Ss,       Gg,       Gg,       Gg,       Gg,       Gg,       Gg,       Gg,       Gg,       Gg,       Gg,       Aa,       Hh
       Ss,       Ss,       Gg,       Ss,       Ww,   Ww^Bw|,       Ww,       Ss,       Ss,       Ss,       Gg,       Ss,       Ss,       Gg,       Gg,       Gg,       Gg,       Gg,       Gg,       Gg,       Gg,       Gg,       Gg,       Gg,       Ss,       Ss,       Gg,       Gg,       Gg,       Gg,       Gg,       Gg,       Gg,       Hh,       Gg,       Aa,       Ha,       Ha
       Ss,       Ss,       Ss,       Ss,       Ww,   Ww^Bw|,       Ww,       Ss,       Ss,       Ss,       Ss,       Ss,       Gg,       Gg,       Gg,       Gg,       Gg,       Gg,       Gg,       Gg,       Gg,       Gg,       Gg,       Gg,       Ss,       Ss,       Gg,       Gg,       Gg,       Gg,       Gg,       Aa,       Aa,   Aa^Fpa,       Aa,       Ha,       Ha,       Aa
       Ss,       Ss,       Ss,       Ss,       Ww,   Ww^Bw|,       Ww,       Ss,       Gg,       Ss,       Ss,       Gg,       Gg,       Gg,    Gg^Vh,       Gg,       Gg,       Gg,       Gg,       Gg,       Gg,       Gg,       Gg,       Gg,       Ss,       Gg,       Gg,       Gg,       Gg,       Gg,   Aa^Vha,       Ha,       Hh,       Ha,       Ha,       Hh,       Aa,       Aa
       Ss,       Ss,       Gg,       Ss,       Ww,   Ww^Bw|,       Ww,       Ss,       Ss,       Ss,       Gg,       Ss,       Ss,       Ss,       Ss,       Gg,       Gg,       Gg,       Gg,       Gg,       Gg,       Gg,       Gg,       Gg,       Ss,       Ss,       Ss,       Gg,       Gg,   Aa^Fpa,       Hh,   Aa^Fpa,       Ha,       Aa,       Ha,       Aa,       Aa,       Aa
       Ss,       Ss,       Ss,       Ss,       Ww,    Gg^Vh,       Ss,       Ss,       Ss,       Ss,       Ss,       Ss,       Ss,       Gg,       Gg,       Gg,       Gg,       Gg,       Gg,       Gg,       Gg,       Gg,       Gg,       Gg,       Ss,       Gg,       Ss,       Gg,       Gg,       Hh,       Ha,       Hh,       Ha,       Aa,       Hh,       Ha,       Aa,       Ha
       Ss,       Gg,       Ss,       Ss,       Ss,       Ss,     2 Kh,       Ss,       Ss,       Ss,       Ss,       Ss,       Ss,       Gg,       Gg,       Gg,       Gg,       Gg,       Gg,       Gg,       Gg,       Gg,       Gg,       Gg,       Ss,       Ss,       Ss,       Ss,       Gg,       Hh,   Aa^Fpa,       Aa,       Aa,       Ha,       Ha,   Aa^Fpa,       Ha,   Aa^Fpa
       Ss,       Ss,       Ss,       Ss,       Ss,       Ss,       Ch,       Ss,       Gg,       Ss,       Ss,       Ss,       Gg,       Ss,       Ss,       Gg,       Gg,       Gg,       Gg,       Gg,       Gg,       Gg,       Gg,       Ss,       Ss,       Gg,       Ss,       Hh,       Ha,       Hh,       Ha,       Aa,       Aa,   Aa^Fpa,       Aa,   Aa^Fpa,   Aa^Fpa,   Aa^Fpa
