border_size=1
usage=map

       Gg,       Gg,       Gg,       Gg,       Gg,       Gg,    Gs^Fp,    Gs^Fp,    Gs^Fp,    Gs^Fp,    Gs^Fp,    Gs^Fp,    Gs^Fp,    Gs^Fp,    Gs^Fp,    Gs^Fp,    Gs^Fp,    Gs^Fp,    Gs^Fp,       Gg,       Gg,       Gg,       Gg,    Gg^Ve,       Gg,       Gg,       Gg,       Ww,       Wo
    Gs^Fp,    Gs^Fp,    Gs^Fp,    Gs^Fp,    Gs^Fp,       Hh,    Gs^Fp,    Gs^Fp,    Gs^Fp,       Gg,       Gg,    Gs^Fp,    Gs^Fp,    Gg^Ve,       Gg,       Gg,       Gg,       Re,       Re,       Re,    Gs^Fp,    Gs^Fp,    Gs^Fp,    Gs^Fp,       Gg,       Gg,       Gg,       Gg,       Ww
    Gs^Fp,    Gs^Fp,    Gs^Fp,    Gs^Fp,    Gs^Fp,    Gs^Fp,       Gg,       Gg,       Gg,       Hh,       Gg,       Gg,       Gg,       Hh,       Gg,       Re,       Re,       Gg,    Gs^Fp,       Gg,       Re,       Re,    Gs^Fp,    Gs^Fp,    Gs^Fp,       Gg,       Gg,       Gg,    Gs^Fp
    Gs^Fp,    Gs^Fp,    Gg^Ve,       Hh,       Gg,       Gg,       Gg,    Gs^Fp,    Gs^Fp,       Gg,       Gg,       Gg,       Gg,       Mm,       Re,       Gg,       Gg,       Gg,    Gs^Fp,    Gs^Fp,    Gg^Ve,       Gg,       Re,       Re,       Re,       Gg,       Gg,    Gs^Fp,    Gs^Fp
    Gs^Fp,    Gs^Fp,    Gs^Fp,       Gg,       Gg,       Gg,    Gs^Fp,       Gg,    Gs^Fp,       Gg,       Gg,       Gg,       Hh,       Ch,       Re,       Gg,       Hh,       Hh,       Gg,       Gg,       Gg,    Gs^Fp,    Gs^Fp,       Gg,    Gs^Fp,       Re,       Gg,       Gg,    Gs^Fp
    Gs^Fp,    Gs^Fp,    Gs^Fp,       Gg,       Gg,       Gg,    Gs^Fp,    Gs^Fp,       Gg,       Gg,    Gg^Ve,       Ch,       Ch,     1 Kh,       Re,       Gg,       Gg,       Gg,       Gg,    Gs^Fp,    Gs^Fp,    Gs^Fp,    Gs^Fp,       Gg,       Gg,       Re,       Gg,       Gg,    Gs^Fp
    Gs^Fp,    Gs^Fp,    Gs^Fp,    Gs^Fp,    Gs^Fp,       Gg,       Gg,       Gg,       Gg,       Gg,       Gg,       Gg,       Ch,       Ch,       Ch,       Gg,       Gg,    Gs^Fp,    Gs^Fp,    Gs^Fp,    Gs^Fp,    Gs^Fp,    Gs^Fp,    Gs^Fp,       Gg,       Gg,       Re,       Gg,       Gg
       Ww,       Ww,       Ww,       Ww,    Gs^Fp,    Gg^Ve,    Gs^Fp,    Gs^Fp,    Gs^Fp,    Gs^Fp,       Gg,       Gg,       Hh,       Hh,       Gg,    Gs^Fp,    Gs^Fp,    Gs^Fp,    Gs^Fp,    Gs^Fp,    Gg^Ve,    Gs^Fp,    Gs^Fp,       Ww,       Ww,       Ww,       Re,       Gg,    Gg^Ve
       Ww,       Ww,       Ww,   Ww^Bw/,   Ww^Bw/,       Ww,       Gg,       Gg,    Gs^Fp,    Gs^Fp,    Gs^Fp,    Gs^Fp,       Gg,       Gg,       Gg,       Hh,       Gg,       Gg,       Gg,       Gg,    Gs^Fp,       Ww,       Ww,       Ww,       Ww,       Ww,       Re,       Re,       Gg
       Ww,       Wo,       Wo,       Wo,       Ww,       Ww,       Gg,       Ww,    Gs^Fp,    Gs^Fp,    Gs^Fp,       Gg,       Gg,       Gg,       Gg,    Gs^Fp,       Hh,    Gs^Fp,       Gg,       Ww,       Ww,       Ww,       Wo,       Wo,       Wo,       Wo,       Ww,       Re,       Gg
       Wo,       Wo,       Wo,       Wo,       Ww,       Ww,   Ww^Bw\,    Gg^Ve,       Gg,    Gs^Fp,    Gs^Fp,    Gs^Fp,       Gg,       Gg,       Gg,       Gg,       Gg,       Gg,       Ww,       Ww,       Wo,       Wo,       Gg,    Gg^Ve,       Wo,       Wo,       Ww,       Ww,       Re
       Wo,       Wo,       Wo,       Ww,       Ww,       Gg,       Gg,       Gg,    Gs^Fp,    Gs^Fp,    Gs^Fp,    Gs^Fp,    Gs^Fp,    Gs^Fp,       Gg,       Gg,       Gg,       Gg,       Gg,       Ww,       Wo,       Wo,       Wo,       Gg,       Wo,       Wo,       Ww,       Ww,       Re
       Wo,       Wo,       Wo,       Wo,       Ww,       Hh,       Gg,       Gg,       Gg,    Gs^Fp,    Gs^Fp,       Hh,       Hh,       Mm,    Gs^Fp,    Gs^Fp,       Gg,       Gg,       Ww,       Ww,       Wo,       Wo,       Wo,       Hh,       Wo,       Wo,       Wo,       Ww,       Re
       Ww,       Ww,       Ww,       Ww,       Ww,       Ww,       Hh,       Hh,       Hh,    Gg^Ve,    Gs^Fp,       Mm,    Gs^Fp,       Hh,       Hh,       Hh,    Gs^Fp,       Gg,       Ww,       Ww,       Ww,       Wo,       Wo,    Gg^Ve,       Wo,       Wo,       Wo,       Ww,       Re
       Ww,   Ww^Bw/,       Gg,       Ww,       Gg,    Gg^Ve,       Hh,       Mm,       Mm,       Mm,       Hh,       Hh,       Hh,       Mm,       Mm,    Gs^Fp,    Gs^Fp,    Gs^Fp,       Ww,       Ww,       Wo,       Wo,       Wo,       Wo,       Wo,       Wo,       Ww,       Ww,       Re
    Gg^Ve,       Ww,       Gg,       Gg,       Gg,       Gg,       Gg,       Hh,       Mm,       Mm,       Mm,    Gg^Ve,       Mm,       Mm,       Mm,       Hh,       Hh,       Gg,       Gg,       Ww,       Ww,       Ww,       Ww,       Ww,       Wo,       Wo,       Ww,   Ww^Bw\,       Gg
       Ww,       Ww,       Wo,       Gg,       Gg,       Gg,       Gg,    Gs^Fp,    Gs^Fp,    Gs^Fp,       Hh,       Hh,       Hh,       Mm,       Mm,       Mm,    Gg^Ve,       Hh,       Gg,       Gg,       Gg,       Ww,       Gg,       Ww,       Wo,       Ww,       Ww,       Re,    Gg^Ve
       Gg,       Gg,       Gg,    Gg^Ve,       Gg,       Gg,    Gs^Fp,    Gs^Fp,    Gs^Fp,       Hh,       Hh,       Mm,       Mm,       Mm,       Mm,       Hh,       Hh,    Gs^Fp,    Gs^Fp,    Gs^Fp,       Gg,       Gg,       Ww,       Ww,       Ww,       Ww,       Re,       Hh,       Hh
       Gg,       Gg,       Gg,       Gg,       Gg,    Gs^Fp,    Gs^Fp,    Gs^Fp,       Hh,       Mm,       Mm,       Mm,       Hh,       Mm,       Mm,       Mm,       Mm,       Mm,    Gs^Fp,    Gs^Fp,    Gs^Fp,       Gg,    Gg^Ve,       Ww,       Ww,   Ww^Bw/,   Ww^Bw/,       Gg,    Gs^Fp
       Ww,       Hh,       Hh,       Gg,       Gg,       Gg,    Gs^Fp,    Gs^Fp,    Gs^Fp,       Mm,       Hh,       Hh,       Hh,       Hh,       Mm,       Mm,       Hh,    Gs^Fp,    Gs^Fp,    Gs^Fp,    Gs^Fp,       Re,       Ww,   Ww^Bw/,   Ww^Bw/,       Ww,       Gg,    Gg^Ve,    Gs^Fp
       Wo,       Ww,       Ww,    Gs^Fp,       Gg,    Gs^Fp,    Gs^Fp,    Gs^Fp,       Hh,       Hh,       Hh,       Mm,       Mm,       Mm,       Hh,       Hh,       Hh,       Hh,    Gs^Fp,    Gs^Fp,       Gg,       Re,   Ww^Bw/,       Ww,       Ww,       Ww,       Gg,    Gs^Fp,    Gs^Fp
       Ww,       Ww,       Gg,       Gg,       Gg,       Gg,       Gg,    Gs^Fp,    Gs^Fp,       Gg,       Gg,    Gs^Fp,       Hh,       Hh,    Gs^Fp,    Gs^Fp,    Gs^Fp,    Gs^Fp,    Gs^Fp,       Re,       Re,       Gg,       Gg,       Ww,       Ww,       Gg,       Gg,       Gg,    Gs^Fp
    Gg^Ve,       Gg,       Gg,       Gg,       Gg,    Gs^Fp,    Gs^Fp,    Gs^Fp,       Gg,       Ch,       Gg,    Gs^Fp,       Gg,       Hh,       Gg,       Re,       Ch,       Re,       Re,       Gg,       Gg,       Gg,       Gg,       Ww,       Gg,       Gg,    Gs^Fp,    Gs^Fp,    Gs^Fp
       Gg,       Gg,       Gg,    Gs^Fp,    Gs^Fp,       Hh,       Hh,    Gs^Fp,       Ch,       Ch,     2 Kh,       Re,       Hh,       Hh,       Re,    Gs^Fp,       Re,       Gg,       Gg,       Gg,       Gg,       Gg,       Ww,       Ww,    Gg^Ve,       Gg,       Gg,    Gs^Fp,       Hh
       Gg,       Gg,    Gg^Ve,       Gg,       Gg,    Gs^Fp,    Gs^Fp,    Gs^Fp,       Hh,       Gg,       Ch,       Ch,       Re,       Re,       Re,       Hh,       Hh,    Gs^Fp,    Gs^Fp,       Ww,       Ww,       Ww,       Ww,       Wo,       Wo,       Ww,       Gg,       Hh,       Mm
       Gg,       Gg,       Gg,       Gg,    Gs^Fp,    Gs^Fp,       Hh,       Hh,       Gg,       Gg,       Gg,       Gg,       Gg,       Gg,       Gg,       Gg,       Mm,       Mm,       Ww,       Ww,       Ww,       Wo,       Wo,       Wo,       Wo,       Wo,       Ww,       Hh,       Mm
