border_size=1
usage=map

       Gg,       Gg,       Gg,       Gg,       Gg,       Gg,    Gs^Fp,    Gs^Fp,       Gg,       Gg,       Gg,       Gg,       Gg,       Gg,       Gg,       Gg,    Gg^Ve,    Uu^Vu,    Gg^Vh,       Ww,       Wo,       Wo,       Wo,       Ds,       Ds,       Gg,       Gg,       Gg,       Gg,       Gg,       Gg,       Gg,       Gg,       Gg,       Gg,       Gg,       Gg,       Gg,       Gg,       Gg,       Gg,       Gg,       Gg,       Gg,       Gg,       Gg,       Gg,       Gg
       Gg,       Gg,       Gg,       Gg,       Gg,    Gs^Fp,    Gs^Fp,    Gs^Fp,    Gs^Fp,    Gs^Fp,       Gg,       Gg,       Gg,       Gg,       Gg,       Gg,       Rr,       Rr,       Rr,       Ww,       Wo,       Ds,       Ww,       Ds,       Gg,       Gg,       Gg,       Gg,       Gg,       Gg,       Gg,       Gg,       Gg,       Gg,       Gg,       Gg,       Gg,       Gg,       Gg,       Gg,       Gg,       Gg,       Gg,       Gg,       Gg,       Gg,       Gg,       Gg
       Gg,       Gg,    Gg^Vh,       Gg,       Gg,    Gs^Fp,    Gg^Ve,       Gg,    Gs^Fp,    Gs^Fp,    Gs^Fp,       Gg,       Gg,       Gg,       Gg,       Gg,       Rr,       Rr,       Rr,   Ww^Bw\,       Ww,       Ds,       Ds,       Gg,       Gg,       Gg,       Gg,       Gg,       Gg,       Gg,       Gg,       Gg,       Gg,       Gg,       Gg,       Gg,       Gg,       Gg,       Gg,       Gg,       Gg,       Gg,       Gg,       Gg,       Gg,       Gg,       Gg,       Gg
       Gg,       Gg,       Gg,       Gg,       Ch,       Ch,       Gg,       Gg,       Gg,    Gs^Fp,    Gs^Fp,       Gg,       Gg,       Gg,       Gg,       Ww,       Ww,       Ww,   Ww^Bw\,       Rr,       Gg,       Gg,       Gg,       Gg,       Gg,       Gg,       Gg,       Gg,    Gg^Ve,       Gg,       Gg,       Gg,       Gg,       Gg,       Gg,       Gg,       Gg,       Gg,       Gg,       Gg,       Gg,       Gg,       Gg,       Gg,       Gg,       Gg,       Gg,       Gg
       Gg,       Gg,    Gs^Fp,    Gs^Fp,       Ch,     1 Kh,       Ch,       Gg,       Gg,       Gg,       Gg,       Gg,       Gg,    Gg^Ve,       Ww,       Ww,       Ww,       Ww,       Ww,       Gg,       Rr,       Rr,       Gg,       Gg,       Gg,       Gg,       Gg,       Gg,       Gg,       Gg,       Gg,       Gg,       Gg,    Gg^Ve,       Gg,       Gg,       Gg,       Gg,       Gg,       Gg,       Gg,       Gg,       Gg,       Gg,       Gg,       Gg,       Gg,       Gg
       Gg,       Gg,       Gg,    Gs^Fp,    Gs^Fp,    Gs^Fp,       Ch,    Gs^Fp,    Gs^Fp,       Gg,       Gg,       Gg,       Hh,       Hh,       Gg,       Gg,       Ww,       Ww,       Gg,       Gg,       Rr,       Rr,       Gg,       Gg,       Gg,       Gg,       Gg,       Gg,       Gg,       Gg,       Gg,       Gg,       Gg,       Gg,       Gg,       Gg,       Gg,       Ch,       Gg,       Gg,       Gg,       Gg,       Gg,       Gg,       Gg,       Gg,       Gg,       Gg
       Ds,       Ds,       Gg,       Gg,    Gs^Fp,    Gs^Fp,    Gs^Fp,    Gs^Fp,    Gs^Fp,       Gg,       Gg,       Hh,       Hh,       Gg,       Gg,   Ww^Bw\,       Ww,       Gg,       Gg,       Gg,       Gg,       Rr,       Rr,       Gg,       Gg,       Gg,       Gg,       Gg,       Gg,       Gg,       Gg,       Gg,       Gg,       Gg,       Gg,       Gg,       Gg,     2 Kh,       Ch,       Ch,       Ch,       Gg,       Gg,       Gg,       Gg,       Gg,       Gg,       Gg
       Ww,       Ww,       Ds,       Gg,       Gg,       Gg,       Gg,       Gg,       Gg,       Hh,       Hh,       Gg,       Gg,       Ww,       Ww,       Gg,       Gg,       Gg,       Gg,       Gg,       Gg,       Gg,       Rr,    Gg^Ve,       Gg,       Gg,       Gg,       Gg,       Gg,       Gg,       Gg,       Gg,       Gg,       Gg,       Gg,       Gg,       Gg,       Ch,       Ch,       Ch,       Gg,       Gg,       Gg,       Gg,       Gg,       Gg,       Gg,       Gg
       Ww,       Ww,       Ww,       Ww,       Gg,       Ww,       Ww,       Hh,       Hh,       Ds,       Ww,       Ww,       Ww,       Gg,       Gg,       Gg,       Gg,       Gg,       Gg,       Gg,       Gg,       Re,       Re,       Re,       Gg,       Gg,       Gg,       Gg,       Gg,       Gg,       Gg,       Hh,       Gg,       Gg,       Gg,       Gg,       Gg,       Gg,       Gg,       Mm,       Gg,       Gg,       Gg,       Gg,       Gg,       Gg,       Gg,       Gg
       Ds,    Gg^Vh,       Ww,       Ww,   Ww^Bw|,       Ww,       Ww,    Gg^Ve,       Gg,       Ww,       Ww,       Gg,       Gg,       Gg,       Gg,       Gg,       Gg,       Gg,       Gg,       Gg,       Gg,       Gg,       Gg,       Re,       Re,       Re,       Gg,       Gg,       Gg,       Gg,       Gg,    Gg^Ve,       Gg,       Gg,       Gg,       Gg,       Gg,       Hh,       Gg,       Hh,       Gg,       Gg,       Gg,    Gs^Fp,    Gs^Fp,    Gs^Fp,    Gs^Fp,    Gs^Fp
       Ds,       Ds,       Ds,       Ds,       Gg,       Gg,       Ww,   Ww^Bw|,       Ww,       Gg,       Gg,       Gg,       Gg,    Gg^Vh,       Gg,       Gg,       Gg,       Gg,       Gg,       Gg,       Gg,       Mm,       Gg,       Gg,       Gg,       Gg,       Re,       Gg,       Gg,       Gg,       Gg,       Gg,       Gg,       Gg,       Gg,       Gg,       Gg,       Gg,       Hh,       Hh,       Gg,       Gg,       Gg,       Gg,       Gg,       Gg,       Gg,       Gg
       Gg,       Gg,       Gg,       Gg,       Gg,       Gg,       Gg,       Gg,       Gg,       Gg,       Gg,       Gg,       Gg,       Gg,       Gg,       Gg,       Gg,       Gg,       Gg,       Mm,       Hh,       Hh,       Hh,       Gg,       Gg,       Gg,       Re,       Gg,       Gg,       Gg,       Gg,       Gg,       Gg,       Gg,       Gg,       Gg,       Gg,       Gg,       Gg,       Gg,       Gg,       Gg,       Gg,       Gg,       Gg,       Gg,       Gg,       Gg
       Gg,       Gg,       Gg,       Gg,       Gg,       Gg,    Gg^Vh,       Gg,       Gg,       Gg,       Gg,       Gg,       Gg,       Gg,       Gg,       Gg,       Gg,       Hh,       Gg,       Hh,       Hh,    Gs^Fp,       Gg,    Gs^Fp,    Gs^Fp,       Gg,       Re,       Re,       Gg,    Gg^Vh,       Gg,       Gg,       Gg,       Gg,       Gg,       Gg,       Gg,       Gg,       Gg,       Gg,       Gg,       Gg,       Gg,       Gg,       Gg,       Gg,       Gg,       Gg
       Gg,       Gg,       Gg,       Gg,       Gg,       Gg,       Gg,       Gg,       Gg,       Gg,       Gg,       Gg,       Gg,       Gg,       Gg,       Gg,       Gg,       Gg,       Gg,    Gs^Fp,    Gs^Fp,    Gs^Fp,    Gs^Fp,    Gs^Fp,    Gs^Fp,       Hh,       Gg,       Re,       Gg,       Gg,       Gg,       Gg,       Gg,       Gg,    Gg^Ve,       Gg,       Gg,       Gg,       Gg,       Gg,       Gg,       Gg,       Gg,       Gg,       Gg,       Gg,       Gg,       Gg
       Gg,       Gg,       Gg,       Gg,       Gg,       Gg,       Gg,       Gg,       Gg,       Gg,       Gg,       Gg,       Gg,       Gg,       Gg,       Gg,       Gg,    Gs^Fp,    Gs^Fp,    Gs^Fp,    Gs^Fp,       Hh,    Gs^Fp,       Gg,       Hh,       Hh,       Mm,       Re,    Gs^Fp,       Gg,       Gg,       Gg,       Gg,       Gg,       Gg,       Gg,       Gg,       Gg,       Gg,       Gg,       Gg,       Gg,       Gg,       Gg,       Gg,       Gg,       Gg,       Gg
       Gg,       Gg,       Gg,       Gg,       Gg,       Gg,       Gg,       Gg,       Gg,       Gg,       Gg,       Gg,       Gg,       Gg,       Gg,       Gg,       Gg,    Gs^Fp,    Gs^Fp,       Hh,    Gs^Fp,    Gs^Fp,    Gs^Fp,       Gg,       Hh,       Gg,       Gg,       Gg,       Re,       Re,       Gg,       Gg,       Gg,       Gg,       Gg,       Gg,       Gg,       Gg,       Gg,       Gg,       Gg,       Gg,       Gg,       Gg,       Gg,       Gg,       Gg,       Gg
       Gg,       Gg,       Gg,       Gg,       Gg,       Gg,       Gg,       Gg,       Gg,       Gg,       Gg,       Gg,       Gg,       Gg,       Gg,       Gg,       Gg,       Gg,    Gs^Fp,    Gs^Fp,    Gs^Fp,    Gs^Fp,    Gs^Fp,    Gg^Vh,       Gg,       Gg,       Gg,       Gg,    Gg^Vh,       Gg,       Re,       Re,       Gg,       Gg,       Gg,    Gg^Vh,       Gg,       Gg,       Gg,       Gg,       Gg,       Gg,       Gg,       Gg,       Gg,       Gg,       Gg,       Gg
       Gg,       Gg,    Gg^Ve,       Gg,       Gg,       Gg,       Gg,       Gg,       Gg,       Gg,       Gg,       Gg,       Gg,       Gg,       Gg,       Gg,       Gg,       Gg,       Gg,       Gg,    Gs^Fp,       Gg,       Gg,       Ww,       Ww,       Ww,       Gg,       Gg,       Gg,       Gg,       Gg,       Re,       Gg,       Gg,       Gg,       Gg,       Gg,       Gg,       Gg,       Gg,       Gg,       Gg,       Gg,       Gg,       Gg,       Gg,       Gg,       Gg
       Gg,       Mm,       Gg,       Hh,       Gg,       Gg,       Gg,       Gg,       Gg,       Gg,       Gg,       Gg,       Gg,       Gg,       Gg,       Gg,       Gg,       Gg,       Gg,       Gg,       Ww,       Ww,       Ww,       Wo,       Wo,       Ww,       Gg,       Gg,       Gg,       Gg,       Gg,       Re,       Gg,       Gg,       Gg,       Gg,       Gg,       Gg,       Ch,       Gg,       Gg,       Gg,       Gg,       Gg,       Gg,       Gg,       Gg,       Gg
       Gg,       Mm,       Mm,       Hh,       Mm,       Hh,       Gg,       Mm,       Mm,       Gg,    Uu^Vu,       Hh,       Gg,    Gg^Ve,       Gg,       Gg,       Gg,       Gg,       Gg,       Gg,       Ww,       Ww,       Wo,       Wo,       Ww,       Gg,       Gg,       Gg,       Gg,       Gg,       Gg,       Re,       Gg,       Gg,       Gg,       Gg,       Gg,       Ch,       Ch,       Ch,       Gg,       Gg,       Gg,       Gg,       Gg,       Gg,       Gg,       Gg
       Gg,       Mm,       Hh,       Mm,       Mm,       Mm,       Hh,       Hh,       Hh,       Hh,       Gg,       Hh,       Mm,       Uu,       Mm,       Uu,       Gg,       Gg,       Gg,       Gg,       Ww,       Ww,       Wo,       Ww,       Ww,       Gg,       Gg,       Gg,       Gg,       Re,       Re,    Gg^Vh,       Gg,       Gg,       Gg,       Gg,       Gg,       Ch,     3 Kh,       Gg,       Gg,       Gg,       Gg,       Gg,       Gg,       Gg,       Gg,       Gg
       Gg,       Ww,       Mm,       Mm,       Mm,       Hh,       Hh,       Mm,       Hh,       Gg,       Gg,       Hh,       Uu,       Uu,       Uu,       Uu,       Uu,       Uu,       Gg,       Gg,       Gg,       Gg,       Ww,       Gg,       Ww,       Ww,       Gg,       Re,       Re,       Gg,       Gg,       Gg,       Gg,       Gg,       Gg,       Gg,       Gg,       Gg,       Ch,       Ch,       Gg,       Gg,       Gg,       Gg,       Gg,       Gg,       Gg,       Gg
       Ww,       Gg,       Gg,       Gg,       Hh,       Gg,       Hh,       Mm,       Mm,       Gg,       Mm,    Uu^Vu,       Uu,       Uu,    Uu^Vu,       Uu,       Mm,       Uu,       Uu,       Gg,       Mm,       Gg,       Gg,       Gg,       Gg,   Ww^Bw/,       Re,       Gg,       Gg,       Gg,       Gg,       Gg,       Gg,       Gg,       Gg,       Gg,       Gg,       Gg,       Gg,       Gg,       Gg,       Gg,       Gg,       Gg,       Gg,       Gg,       Gg,       Gg
   Ww^Bw\,    Gg^Vh,       Gg,    Gg^Ve,       Gg,       Gg,       Mm,       Gg,       Gg,       Hh,       Mm,       Mm,       Mm,       Uu,       Uu,       Uu,       Uu,       Mm,       Uu,       Mm,       Mm,       Re,       Re,       Re,       Re,       Ww,       Gg,       Gg,       Gg,    Gg^Ve,       Gg,       Gg,       Gg,       Gg,       Gg,       Gg,       Gg,       Gg,       Gg,       Gg,       Gg,       Gg,       Gg,       Gg,       Gg,       Gg,       Gg,       Gg
       Ww,       Ww,       Gg,       Gg,       Gg,       Gg,       Mm,       Gg,       Hh,       Hh,       Hh,       Uu,       Uu,       Uu,       Uu,       Gg,       Mm,       Gg,       Gg,       Re,       Re,       Gg,       Gg,       Gg,       Gg,       Ww,       Gg,       Gg,       Gg,       Gg,       Gg,       Gg,       Gg,       Gg,       Gg,       Gg,       Gg,       Gg,       Gg,       Gg,       Gg,       Gg,       Gg,       Hh,    Gs^Fp,       Gg,       Gg,       Gg
       Ww,       Mm,       Gg,       Gg,       Gg,       Gg,       Gg,       Hh,    Uu^Vu,       Mm,       Hh,       Gg,       Gg,       Gg,       Gg,       Gg,       Gg,       Gg,       Gg,       Gg,       Gg,       Gg,       Gg,       Gg,    Uu^Vu,       Ww,       Ww,       Ww,       Gg,       Gg,       Gg,       Gg,       Gg,       Gg,       Gg,       Gg,    Gg^Vh,       Gg,       Gg,       Gg,       Gg,       Gg,    Gs^Fp,       Gg,       Hh,       Gg,       Gg,       Gg
       Hh,       Hh,    Gs^Fp,       Hh,       Hh,       Gg,       Hh,       Mm,       Mm,       Mm,       Gg,       Mm,       Gg,       Gg,       Gg,       Gg,       Gg,       Gg,       Gg,       Gg,       Gg,       Gg,       Gg,       Gg,       Gg,       Gg,       Gg,       Ww,       Ww,   Ww^Bw|,       Gg,       Gg,    Gg^Ve,       Gg,       Gg,       Gg,       Gg,       Gg,       Gg,       Gg,       Gg,       Gg,    Gs^Fp,       Hh,    Gs^Fp,       Hh,    Gs^Fp,    Gs^Fp
    Gg^Ve,       Mm,       Mm,       Gg,       Gg,       Mm,       Mm,       Mm,       Mm,       Gg,       Mm,       Mm,       Gg,       Hh,       Mm,       Mm,       Gg,    Gs^Fp,       Mm,       Gg,       Gg,       Gg,       Gg,    Gg^Ve,       Gg,       Gg,       Gg,       Gg,       Ww,       Gg,       Ww,       Ww,       Ww,       Ww,       Gg,       Gg,       Gg,       Gg,       Gg,       Gg,    Gg^Ve,       Gg,       Gg,    Gg^Ve,    Gs^Fp,    Gs^Fp,       Gg,    Gs^Fp
       Hh,       Hh,       Gg,       Hh,       Hh,       Gg,       Mm,       Gg,       Gg,       Gg,       Mm,       Gg,       Gg,       Gg,    Gs^Fp,       Gg,       Hh,    Gs^Fp,       Gg,       Mm,       Gg,    Gs^Fp,       Gg,       Gg,       Gg,       Gg,       Gg,       Gg,       Gg,       Gg,       Gg,       Ww,       Wo,       Ww,       Ww,       Ww,       Gg,       Gg,       Gg,       Gg,       Gg,       Gg,    Gs^Fp,    Gs^Fp,       Hh,       Gg,       Gg,       Gg
       Gg,       Gg,       Gg,       Gg,       Gg,       Gg,       Gg,       Gg,       Gg,       Gg,       Gg,       Gg,       Gg,       Gg,       Gg,       Gg,    Gs^Fp,       Gg,       Gg,       Gg,    Gg^Ve,       Gg,       Gg,       Gg,       Gg,       Gg,       Gg,       Gg,       Gg,       Gg,       Gg,       Ww,       Wo,       Wo,       Ww,       Ww,       Ww,       Gg,       Gg,       Gg,       Gg,       Gg,    Gs^Fp,       Gg,       Hh,       Gg,    Gs^Fp,       Gg
       Gg,       Gg,       Gg,       Gg,       Gg,       Gg,    Gg^Ve,       Gg,       Gg,       Gg,       Gg,       Gg,       Gg,       Gg,       Gg,       Gg,       Mm,       Gg,       Gg,       Gg,       Gg,       Gg,       Gg,       Gg,       Gg,       Gg,       Gg,       Gg,       Gg,    Gg^Ve,       Gg,       Ww,       Ww,       Wo,       Wo,       Ww,       Ww,       Ds,       Gg,       Ds,       Gg,       Ds,       Gg,       Ds,       Ds,       Ds,       Gg,       Gg
       Gg,       Gg,       Gg,       Gg,       Gg,       Gg,       Gg,       Gg,       Gg,       Gg,       Ch,       Ch,       Gg,       Gg,       Gg,       Gg,       Gg,       Gg,       Gg,       Gg,       Gg,       Gg,       Gg,       Gg,       Gg,       Gg,       Gg,       Gg,       Gg,       Gg,       Gg,       Gg,       Ww,       Ww,       Ww,       Ww,       Ww,       Ds,       Gg,       Gg,       Gg,       Gg,       Ds,       Ds,       Ds,       Ds,       Gg,       Gg
       Gg,       Gg,       Gg,       Gg,       Gg,       Gg,       Gg,       Gg,       Gg,       Mm,     4 Kh,       Ch,       Ch,       Gg,       Gg,       Gg,       Gg,       Gg,       Gg,       Gg,       Gg,       Gg,       Gg,       Gg,       Gg,       Gg,       Gg,       Gg,       Gg,       Gg,       Gg,       Gg,       Gg,       Gg,       Ds,       Ds,       Ww,       Ds,       Ds,       Ds,       Gg,       Gg,       Gg,       Gg,       Ds,       Ds,       Ds,       Ds
       Gg,       Gg,       Gg,       Gg,       Gg,       Gg,       Gg,       Gg,       Gg,       Gg,       Ch,       Gg,       Gg,       Gg,       Gg,       Gg,       Gg,       Gg,       Gg,       Gg,       Gg,       Gg,       Gg,       Gg,       Gg,       Gg,       Gg,       Ds,       Gg,       Ds,       Ds,       Gg,       Gg,       Gg,       Ds,       Ds,       Ww,       Ds,       Ds,       Gg,    Gg^Ve,       Gg,       Gg,       Ds,       Ds,       Gg,       Gg,       Gg
       Gg,       Gg,       Gg,       Gg,       Gg,       Gg,       Gg,       Gg,       Gg,       Gg,       Gg,       Gg,       Gg,       Gg,       Gg,       Gg,       Gg,       Gg,       Gg,       Gg,       Gg,       Gg,       Gg,       Gg,       Gg,       Ds,       Gg,       Ds,       Ds,       Gg,       Ds,       Gg,    Gs^Fp,    Gs^Fp,    Gs^Fp,       Ds,       Ds,       Ds,       Ds,       Gg,       Gg,       Ds,       Gg,       Gg,       Ds,       Gg,       Ds,       Ds
       Gg,       Gg,       Gg,       Gg,       Gg,       Gg,    Gg^Ve,       Gg,       Gg,       Gg,       Gg,       Gg,       Gg,       Gg,       Gg,       Gg,       Gg,       Gg,       Gg,       Ds,       Ds,       Ds,       Gg,       Ds,       Ds,       Gg,       Ds,       Gg,       Ds,       Gg,       Ds,       Ds,       Ds,       Ds,       Gg,       Gg,       Ds,       Gg,       Ds,       Gg,       Ds,       Gg,       Ds,       Gg,       Gg,       Gg,       Ds,       Ds
       Gg,       Gg,       Gg,       Gg,       Gg,       Gg,       Gg,       Gg,       Gg,       Gg,       Gg,       Gg,       Gg,       Gg,       Gg,       Gg,       Gg,       Gg,       Ds,       Ds,       Ds,       Ds,       Gg,       Ds,       Gg,       Ds,       Gg,       Gg,    Gs^Fp,    Gs^Fp,    Gs^Fp,       Mm,    Gs^Fp,    Gs^Fp,       Ds,    Gs^Fp,       Gg,       Hh,       Hh,       Gg,       Gg,       Ds,       Ds,       Ds,       Ds,       Gg,       Gg,       Gg
       Gg,       Gg,       Gg,       Gg,       Gg,       Gg,       Gg,       Gg,       Gg,       Gg,       Gg,       Gg,       Gg,       Gg,       Gg,       Gg,       Ds,       Gg,       Ds,       Ds,       Ds,       Ds,       Ds,       Ds,       Ds,       Gg,    Gs^Fp,    Gs^Fp,    Gs^Fp,    Gs^Fp,       Gg,       Hh,    Gs^Fp,       Gg,       Gg,       Ds,    Gs^Fp,       Mm,    Gs^Fp,    Gs^Fp,    Gs^Fp,       Ds,       Gg,       Gg,       Ds,       Ds,       Ds,       Gg
       Gg,       Gg,       Gg,       Gg,       Gg,       Gg,       Gg,       Gg,       Gg,       Gg,       Gg,       Gg,       Gg,       Gg,       Gg,       Gg,       Gg,       Gg,       Ds,       Ds,       Gg,       Ds,       Ds,       Ds,       Gg,       Gg,       Ds,       Ds,    Gs^Fp,       Hh,    Gs^Fp,       Gg,       Ds,    Gg^Ve,       Hh,       Ds,       Gg,       Gg,       Gg,       Gg,       Gg,       Gg,       Ds,       Ds,       Ds,       Ds,       Ds,       Ds
       Gg,       Gg,       Gg,       Gg,       Gg,       Gg,       Gg,       Gg,       Gg,       Gg,       Gg,       Gg,       Gg,       Gg,       Gg,       Gg,       Gg,       Gg,       Gg,       Gg,       Gg,       Gg,       Gg,       Gg,       Gg,       Gg,       Ds,    Gs^Fp,    Gs^Fp,       Gg,       Hh,       Hh,       Gg,       Gg,       Gg,       Gg,       Ds,       Gg,       Gg,       Ds,       Gg,       Gg,       Gg,       Ds,       Ds,       Ds,       Ds,       Gg
       Gg,       Gg,       Gg,       Gg,       Gg,       Gg,       Gg,       Gg,       Gg,       Gg,       Gg,       Gg,       Gg,       Gg,       Gg,       Gg,       Gg,       Gg,       Gg,       Gg,       Gg,       Gg,       Gg,       Gg,       Gg,       Gg,       Gg,       Gg,       Ds,       Gg,       Ds,       Gg,       Gg,       Gg,       Ds,       Ww,       Gg,       Gg,       Gg,       Gg,       Gg,       Gg,       Gg,       Ds,       Ds,       Gg,       Gg,       Gg
